#s####################
#    #               #
# ## # #### ######## #
# #  #    # ###### # #
# ####### #        # #
#   #   # ########## #
### #  ##      #     #
#     ##    #  # #####
# #####     ####     #
#         #  #   #####
#         #  #       #
####################e#